============================
=............==............=
=.====.=====.==.=====.====.=
=O====.=====.==.=====.====O=
=.====.=====.==.=====.====.=
=..........................=
=.====.==.========.==.====.=
=.====.==....==............=
=......     .==............=

=......=====.==............=
======.=

======
xxxx
=
=
=

 ..........................

============================
